NO ./path_to_the_north_texture
SO ./path_to_the_south_texture
WE ./path_to_the_west_texture
EA ./path_to_the_east_texture

F 244,164,96
C 230,230,250

        1111111111111111111111111
        1000000000110000000000011
        1011000001110000000000001
        1001000000000000000000001
111111111011000001110000000000001
100000000011000001110111100111111
111101111111110111000000100011111
11110111111111011101010010001
11000000110101011100000010001
10000000000000001100000010001
10000000000000001101010010001
110000011101010111110111100111
11110111 1110101 101111010N001
11111111 1111111 1111111111111