NO ./textures/NO.png
SO ./textures/SO.png
WE ./textures/WE.png
EA ./textures/EA.png

F 244,164,96
C 230,230,250

        1111111111111111111111111
        1000000000000000000000001
        1000011000000000000000001
        11D1111000000000000000001
111111111000000000000001111D10001
100000000000000000000000000000001
10000000000000000000N000000011111
10000000000000000000000000001    
10000000000010000000000000001
10000000000000000000000000001
10000000000000000000000000001
100000011100000111000000000011
10000001 1000001 1000000000001
11111111 1111111 1111111111111