NO ./textures/NO.png
SO ./textures/SO.png
WE ./textures/WE.png
EA ./textures/EA.png

F 244,164,96
C 230,230,250

        1111111111111111111111111
        1000000000110000000000001
        1011000001110000000000001
        1001000000D00000000000001
111111111D11000001110000000000001
10000000001100000111011111D111111
1111D111111111011100000010001
11110111111111011101010010001
11000000110101011100000010001
10000000000000001100000010001
10000000000000000001D10010001
110000011101D1011101011010N0111
11110111 1110101 101111010001
11111111 1111111 111111111111