NO ./textures/NO.png
SO ./textures/SO.png
WE ./textures/WE.png
EA ./textures/EA.png

F 8, 12, 1
C 38, 44, 46

        1111111111111111111111111
        1000000000110010001000001
        101111000111D111D11000001
        1011000000D000D000D000001
111111111D11000001110110001000001
100000000011000001110111111111111
1111D111111111011100000010001
11110111111111D111D1011111D11
110000001101010111000D0010001
10000000D00000001100010011011
10000000100000000001D10010001
110000011101D1011101011000001
11110111 1110101 101111010N01
11111111 1111111 111111111111