NO ./textures/NO.png
SO ./textures/SO.png
WE ./textures/WE.png
EA ./textures/EA.png

F 244,164,96
C 230,230,250

        1111111111111111111111111
        1000000000110000000000001
        1D11000001110000000000001
        1001000000D00000000000001
111111111011000001110000000000001
10000000001100000111D111110111111
11110111111111011100000010001
1111D111111111011101010010W01
11000000110101011100000010001
10000000000000001100000010001
100000005000000000001010010001
110000011101010111D1011010N0111
11110111 1110101 101111010001
11111111 1111111 111111111111